Steamworks已连接=已连接到 Steam：{0}
Steamworks未连接=无法连接到 Steam
Steamworks在写入物品ID时发生错误=将 ID 写入清单时发生错误：{0}。注意物品 {1} 已经创建成功，是否重试写入？如果取消将不会上传内容并就此终止，Steam 上的物品将成为一个空物品！
Steamworks开始创建物品=开始创建新物品
Steamworks已创建物品=已创建新物品：{0}
Steamworks创建物品失败=创建物品时发生类型为 {0} 的错误
Steamworks物品信息已更新=已更新物品信息：{0}，正在让 Steam 上传
Steamworks上传成功=Steam 已完成上传物品：{0}
Steamworks上传失败=上传时发生类型为 {0} 的错误
Steamworks取消订阅成功=已取消订阅物品：{0}
Steamworks取消订阅失败=取消订阅时发生类型为 {0} 的错误


当前没有载入模组=当前没有载入模组
当前模组文件夹显示=当前模组文件夹：
未保存的工作将丢失=请确认你当前模组的数据已经保存到硬盘，继续操作会让未保存的工作丢失不可恢复
选择新模组保存位置=选择新模组保存位置
所选的模组不包含清单=所选的模组文件夹不包含清单文件，请使用创建新模组
已保存数据=已保存数据
已有创意工坊ID请使用上传更新功能=此模组已经有创意工坊 ID，请使用【上传更新】功能
模组名称未设置=模组名称未设置
UniqueID 未设置=UniqueID 未设置
分级未设置=分级未设置
适用版本未设置=适用版本未设置
标签未设置=标签未设置
确保已经保存到硬盘=请确认你当前模组的数据已经保存到硬盘，未保存的更改不会被上传且影响程序判断必填项




功能显示名称描述=此处更改游戏内各项功能所显示的名称<br><br>例如你想做 Stellaris 那样的世界观，可以把殖民地改为星球，把载具改为舰船<br><br>或者描绘像 Frostpunk 那样的场景，可以把殖民地改为定居点等
通用统计资源描述=通用统计资源显示在每个殖民地概览中的资源存量视图中<br><br>这直观反映了殖民地的主要产出，诸如像电力、水资源、食物配给等<br><br>世界内的通用货币也需要通过这种方式添加，常用的名词有金币、信用点等<br><br>当然像木材、石材、矿物等可以放在仓库里吃灰的材料请放到物品系统里<br><br>要留意游戏和模组作者所定义的资源 ID，这样你才能操作那些资源
殖民地系统描述=殖民地系统的设计与 Stellaris 中的星球相似，包括物种、区划、建筑、决议等<br><br>除此之外还可以访问其他功能以及区域，例如农田、餐厅、酒馆、放映室等<br><br>一旦殖民地被发现并维持存在就会一直占用游戏刻计算性能，游戏可以使用多线程来降低计算延迟<br><br>每个殖民地的科技树都是独立的，科技也可以成为殖民地之间的交易内容<br><br>殖民地人口可以参与事件和环境的计算，从中获得或者损失人口
全部物品描述=在官方剧本中，使用了元素周期表作为基础材料<br><br>成品材料直接能够被用于各种需求，例如建造等<br><br>收藏品可以是多种样式，比如链接到图片、改变背景音乐、在放映室中播放视频等
角色系统描述=角色系统是以原神和星穹铁道为参考并修改后的设计<br><br>总体上十分相似应该很容易理解，不过现在你可以完全定制角色了，你就偷着乐吧
载具系统描述=载具系统是按照 Stellaris 的飞船设计简化来的<br><br>海陆空题材都可以兼容，当然程序里没有定义海陆空，你硬要在陆地上开军舰也是可以的<br><br>需要使用带有 AI 属性的技能部件才能让载具在不坐人的情况下行动
NPC系统描述=在剧情设计上，这些你无法操作的 NPC 是带入并推动剧情的重要元素<br><br>必须在这里定义 NPC 数据之后才能在事件以及其他对话中调用 NPC
农牧渔系统描述=地是要种的，畜是要养的，鱼是要钓的<br><br>就算是把殖民地搬到太空里这些也是要有的
烹饪系统描述=如果要使用餐厅玩法，需要使用这里的食谱数据
世界地图描述=世界地图是基于箱庭式的点阵矩形，由大量的正方形格子组成<br><br>每一个格子都有独立的数据，格子可以批量生成矩形范围也可以单独指定坐标<br><br>若要对格子设定图片，需要先在媒体资源中添加对应图片<br><br>地图上的图片会在运行时存于运行内存中，请勿使用体积太大的图片